1111111
10000P1
1P000C1
1111111