1111111111111111111111111111111111
10000000000P00C00000C000000000EC01
1111111111111111111111111111111111
