1111111111111
1000000000001
100C00E000001
10000000000P1
1111111111111