1111111111111
100000000001
100C00E0s0001
10000000000P1
1111111111111